222222222222222222222222222222222222222222222
222222222222222222222222222222222222222222222
220000000000000111100000011110000000000000022
220000000000111111111100111111110000000000022
220000000111111111111111111111111110000000022
220000011111111111111111111111111111110000022
220000111111111111111111111111111111111000022
220001111111111111111111111111111111111100022
220001111111111111111111111111111111111100022
220001111111111111111111111111111111111100022
220000111111111111111111111111111111111000022
220000011111111111111111111111111111110000022
220000001111111111111111111111111111100000022
220000000111111111111111111111111111000000022
220000000011111111111111111111111100000000022
220000000001111111111111111111111000000000022
220000000000111111111111111111100000000000022
220000000000011111111111111111000000000000022
221111000000001111111111111110000000001111122
221111100000000111111111111100000000011111122
221111110000000011111111111000000000111111122
221111111000000001111111110000000011111111122
221111111100000000111111100000000111111111122
220111111110000000011111000000001111111110022
220011111111000000001110000000011111111100022
220001111111100000000000000000111111111000022
220000111111110000000000000001111111110000022
220000011111111100000000000111111111100000022
220000001111111111000000111111111111000000022
220000000111111111100011111111111110000000022
220000000011111111111111111111111100000000022
220000000001111111111111111111111000000000022
220111110001111111111111111111111111011111022
220111110001111111111111111111111111011111022
220111110001111111111111111111111111011111022
220111111101111111111111111111111111111111022
220111111101111111111111111111111111111111022
220111111101111111111111111111111111111111022
220111111101111111111111111111111111111111022
220111111101111111111111111111111111111111022
220111111101111111111111111111111111111111022
220111111101111111111111111111111111111111022
220111111101111111111111111111111111111111022
220111111101111111111111111111111111111111022
220111111101111111111111111111111111111111022
220111111101111111111111111111111111111111022
220111111101111111111111111111111111111111022
220111111101111111111111111111111111111111022
220111111101111111111111111111111111111111022
220111111101111111111111111111111111111111022
222222222222222222222222222222222222222222222
222222222222222222222222222222222222222222222
