222222222222222222222222222222222222222222222
222222222222222222222222222222222222222222222
220000000000000000000000000000000000000000022
220000000000000000000000000000000000000000022
220000000000000001111000000000000000000000022
220000000000000001111000000000000000000000022
220000000000111111111111110000000000000000022
220000000000111111111111110000000000000000022
220000000111111144444111111100000000000000022
220000000111111144444111111100000000000000022
220011111111144144444441141111111110000000022
220033333111144144444441141113333311100000022
220033333111144144444441141113333311100000022
220000000111111144444111111100000000000000022
220000000111111144444111111100000000000000022
220000000000111111111111110000000000000000022
220000000000111111111111110000000000000000022
220000000000000001111000000000000000000000022
220000000000000001111000000000000000000000022
220000000000000000000000000000000000000000022
220000000000000000000000000000000000000000022
221111100111330000000000000000033111001111122
221133300111330000000000000000033111003331122
221133300111110001333333333100011111003331122
220000000000000001333333333100000000000000022
220000000000000001114444411100000000000000022
220001144413300001114444411100011444111100022
220001144413300001111111111100011444111100022
220001144411100001111111111100033444111100022
220001144411100001111111111100033444111100022
220001144413300001111333111100011444111100022
220001144413300001114333411100011444111100022
220001144411100004444444444400033444111100022
220001144411100004444444444400033444111100022
220001144411100000011111110000033444111100022
220001144413300000011111110000011444111100022
220001144413300000011666110000011444111100022
220001111111100000011666110000011113333330022
220001111111100000011666110000011113333330022
222222222222222222222222222222222222222222222
222222222222222222222222222222222222222222222
